%%%%%%%%%%%%%%%%%%%%
%O...%........%....%
%.%%.%.%%..%%.%.%%.%
%...... G   %......%
%.%.%%.%% %%%.%%.%.%
%.%....%    %.%..%.%
%.%.%%.% %% %.%.%%.%
%.%......P....%....%
%%%%%%%%%%%%%%%%%%%%
