%%%%%%%%%%%%%%%%%%%%
%....%........%....%
%.%%.%.%%%%%%.%.%%.%
%.%..............%.%
%.%.%%.%%   %%.%%..%
%......%% G %......%
%.%.%%.%%%%%%.%%.%.%
%.%..............%.%
%.%%.%.%%%%%%.%.%%.%
%....%.P....O.%....%
%%%%%%%%%%%%%%%%%%%%
