%%%%%%%%%%%%%%%%%%%%
%......%   G%......%
%.%%...%%  %%...%%.%
%.% .%........%. %.%
%.%%.%.%%%%%%.%.%%.%
%..P...........O...%
%%%%%%%%%%%%%%%%%%%%
