%%%%%%%%
%   P O%
%G%%%%%%
%....  %
%%%%%%%%
